######.#####.###
#..........#.#.#
#.#####.##.#...#
#.#......#.###.#
#.#.###..#...#.#
##..#..##.#..#.#
#..#.....#...#.#
###..###...###.#
#...#...#..#.#.#
#.....##.....#.#
#..####...#..#.#
#.#....#..#..#.#
#...#..#.#...#.#
#..#..#.#..###.#
#.#..#..#.#....#
#.#...#.#.#..###
##..#.##.#..#..#
#..#.#...#.#...#
##....#..#.##..#
#......#.#...#.#
#..##...#.#....#
#....#..#..###.#
#..#.#..#..#.#.#
#.#..###.#.#.#.#
##.......#...#.#
#..######..#.#.#
#..........#...#
################