#.##################################################################################################
#.#........##....#.#..##.##.#.##.##.##..#.##.#.#....##.#...#..#.##...##..#......##.#.#.#.#.#.#.....#
#.#######.####.###.#.##..##.#.##.#...##...#....#.#####.##.##.##.###.####...#######.#.#.#.#.....###.#
#..##.......##.#.#.#.###....#..#.#.######.#.####.#.#.#.#.........##..##..#####.##....#.#...#####.###
##..#.#.###.##...#.#..###.#.#.##.#.....##........#.#.#...#.##.######.###...#.#.####.##...#..##.#...#
#..######....###.....##.#.#....#.#.#######.#####.#.#.#.#####..##.##...##.###....###....#.##..#.#.###
##..#######.####.#####..###.####....#.#.#....#####.#.......#.###..###.#....#.####...##########.#.#.#
#..##.#.#...##.#.#.#.##..#.......####...#.####.##..#.#####.###.##.#.#.##.###.#..##.##..##..#.#.#...#
##..#.#.###.##.#.#.#..#.##.#######..###...#.......##.##..#.##..#..#.#.##..##...##...#.###.##.....###
##.##.#.##..##.#.#.#.##........##..##...#.#.########....######.##......#.##..###..#...#.#..#####...#
#..##...###..#.#.....#..##########..###.###....###.#.#####..#..####.##.#..##..#..###.##.#.##.##..###
##..###..###...###.###.##.#.##.##..##....##.####.......#.##.##..#.####.#.###.##.######.....#..##...#
###..###...##.##.#.##...#....#.###..####.......##.##.###..#..##.#..##..#.##..#....#.##.#####.##..###
#...##.##.##..##.#.##.###.####.#.##.##.#.#######..####.#.##.##..#.##..##..##.#.####.##..#.#.....####
###.##.#..##.##.....#.###..#.#....#.##.#...##.##.##.#........##.#..##..#.##....#....##.##.##.####..#
#...#....##..#####.##.#.#.##.#.####.##.#.###..##.##.#.########....###.##....##.#.####...#.....####.#
###.###.####.#.#.#.##.#.#.##...##.#.#..#...##..#....#..##.###..####......#.##......####...##.##..#.#
###.....##.........##.#.#..##.##......##.###..##.####.##..#.##.##.###.#.##.####.#.##.##.########.#.#
#.##.##..##.######.##.#...##...####.###..#.##.##.......#.##.##.##.#.#.######.##.#.#..##..#...##....#
#..#####..#.#......##.#.#.###.##.#......##.##..#.#######.##..#.##...#.##.###.#######..##...######.##
#.###....#########.##.#.###.#.#....####.##..#.##.##..#.#.#..##.####............#..###.##.###.#.#...#
#.#.####..##.......##.#..##.#.#.####..###..##.#...#.##.#...##..#.#..############.##.#.#....#.#.#.###
#.#.#..##..####.##..#.#.###.....#..##..##.###...###.##.##.####.#.##....##...#.##.#......####.#.....#
#.#.##....##..#####.#.#.##..#####.##..###.##..###.#..#.##..#.#.#..##.###..###.##.#.####.##...#.#####
#.#..#.##.###.###.....#.###..#..#..##.#....##.......##.#..##.#.#.##....#.###..#..#....#####.##.....#
#...####...##.#.#####....##.##.##.##..#.####..##.####..#.##.......##.###...##.##.#.####..##.##.#####
#.###.#..#.##...##.#####.#...#.....##.....##.######...##..##.####.##...#.###..##.#..#.##.##.##.....#
#.#.#.####.####.##..###..##.##.#####..#####.......###.#..##....#####.###.##..##....##..#.##....#.#.#
#.#.#..##..#.#..##.##.##.##..#.#.#.##..#..##.###.##...##..##.###.#.#.###..##..##.#.#..##.##.########
#...##..##.#.##.##.#..##....##.#......##.##..#.######..#.##..###.#.#.#.##.#..##..####........##.#.##
##.##..###.#..#.#..##.####.##..#.######...##.#..#.#.##.#..##...#.#......#.#.####..#.#.######.......#
#...#.##...##.#.##....#.#.....##...#..##.###...##.#.#....##..###.#.######....#.#.##.#.##.#.##.######
###...####.......####.#.####.###.###.##..#.#.###..#.####.##.##.#....##.###.###...#..........#..#...#
#...#.#.###.#.##.###..#..##..##..#.#.#..##...#.#.##.##...##.##.#.####...#....###...###.#########.###
###.#.#.#.#####......##.####.###.....#.##..###....#..###.##.##......##.##.######.##########.###...##
#.#.###....#.####.##.....##...#..##.##..##.#.#.####.##......##.#######.##.#.##..................#..#
#....#..####...#####.#.######...#######.........##..#######.##.#..#.#..........##.##.#.####.#.#.##.#
####.#.##..###.#.#...#..##.####.#..#.#..##########.##.##.....#.#.##...##.###########################
#..#.#..##.#.#...##.##.###..##..#.##.#.########....##.#####.##....###.####.#...#..#.#.##.......##.##
##...##.##...###.##.#....##.###....#..........##.#.##..###..###.#####.#.##.#.###.##....#.#######...#
####.......####...######..#..##.####.##########..#####...##..##..##.#.#.#......#..#.##.....##..###.#
#....#####..#.##.###...#.##.##.........#..##..##.##..#.###..####......#.#.######.##..#.#######..#..#
########.#.##.#..#.###.#..#.###.####.###.###.###..##...#.#.#####.####......#.#.#.#..##.##.#.#..##.##
#..###...#..#.##....#..#.##..##....###.#.#.#.#.##..###...#.#.##...#.####.#.........######...##..#.##
##.#.###.##.#.#####.##.#.##.##..##..##.#...#.#.##.##.##.##.#.#..#....#######.####.##.##...###..##..#
#....##.........##..##.#.....#.##..##..#.###...##....##.##...##.##.###.##..#....####..###.#.##.#..##
###.##..####.######......##.##.######.##...##.###.####..###.##...###......##.#####.##..#.........###
#....####.#....#.######.#####...#.#....#.###...#...#.##........#..###.#####....##.....##.###.##.####
####..##..#.####.#.###..##.#..###.###.##.###.#...###..#.###.#.###.......########..#####...#######.##
##.##..##......#.#.#.#.##..#.###..#.#.#....###.###.##.####..###.###.##.##...##.##..#.##.#...##..#..#
#..##.##..##.###.#.#....##.....#.##.#.#.#####......##..##..####...#.##....###..##.##.##.##.###.##.##
#.##...#.###..##.#.###.####.#.##..#.#...##.#..########.#..###...#.#..##.###.#.##...#.##..#...#.#...#
#..#.#####.#.##..#.#.#...##.###..##.#.####...##....##..##...##.########..#....####...##.####.#.#.###
##.#.#.##..#..##.......#..#.####.##.....#..###..##.###.##.###.......#.####.####.##.####.#.####....##
##.#.#..##.#.########.#####.#..#.##.#####.####.#####.#.#..#.#.#.#.###..##....##....###.....###.##..#
#..#.#.##.......##.....##.#...##.##....##....#.#.##..#.#.##.#.######..##..#.####.#...##.####....#.##
##.#....######.######.##..#.###..#..####..####....##.#.#.#.....#.#.##..#.##..#.#.######......#######
#....##..###...##..#...##.#.#.##.#.##..##.##...####..#.#.#.#####.#..##....####.....##...####....##.#
##.#####...###..##.##.###.#.#.##.#.###.#...###....##.#.#.#.#.#.#.#.###.##..####.#####.############.#
#####..###...##..#.##.#.#.#.#..#....##.#.####..#####.................#.#####.##...#.#......##..##..#
#.#.##.##..####.##.##.#.....##...####..#.#..#.##.#...#.#.#.#######.###.#.#.#.##.#.....#######.##..##
#.......##..##...#.#....#####..###.###.....##......#####.#.......#####.#........#####....###.....###
##.##.#.###..###...##.###.#.##..##.#.#.########.#####.##.#.########..#.#.#####.###.#######.#.##.####
#######.#.#.##.#.####.#.#...##.##....#.#...##......#...#######.#..##.#.#....####.#.#.#.#.#.#.##.#.##
#.........#.......##....##.##...##.###...######.##...#..#.#..#.#.###.#.#.####.#..#............###..#
#########.####.#.####.###..##.#.#....#.########.#######.....##.#.##........#....##.###.#########..##
#.###.###.#..###.##.#..###.##.###.####.#.#.##......##.###.####....###.######.##.....####.#....#..###
#.#.....#.#.##...##...##.#.##..##.##.#.....####.####...#####.###.##......###..#.#.#.#.##.#.####.####
#.###.#......###..###.##.#.###.##.#..#.#.#..##.....#.#..##....##....#.#.##.#.########.#...........##
#.#.####.#.#..#..###..##.#.#.#.##...##.###.###.#####.####..#####.##.#.#......#.#.#.##.#.#########..#
#....#.#####.##.##.##.##.....#..#.#.#...####.......#....##.##..#.##.#.##.#.#.....#.#........########
##.#...##.#...#..#.#..###.##.#.##.###.#.#.##.###.###.####...##....###..#.#.##.##.....##.#.###....###
######.##.###.##...##.#.####.......##.###......###.#..#.##.####.#..###.#.#..#####.#.#####.....####.#
#.#....##.#......#..#.#.##.##.##.####..##.##.#..##.#.##.##.#....#.##.#########.#..####.####.#......#
#.##.#.##.##.######...#.#..#...####.#.###.#####.##...........####.....#........##.......######.#####
#.####.##..##########...##...#####..#........####..####.#.##....#.#####.##########.##.###...##.....#
#.#.#..#..###....#.###.####.##...#.##.####.###.#..##....#..###.#######.......##.##..###.#.###..#####
#.#.##.#.##.####....#..##.#.#..###.##....###.#...####.#.#.########.....#.#.#....##.####.#...##.....#
#.........#..##..##...###.....##....#.#####....###.##.#.#.......#..##.######.##..#........#..##.##.#
######.##.##..#.#####.#.#.######.####...##..#.####..#####.#.#####.######..##########.######.##..####
##.#####...##.###.#...#..........###..#..#.#####...###..#.#.....#..#.#.##..##.....##.##...#..##...##
#..#..#..#.....#..###...##########...###.........###.#.##.#.#.#...##...##.###.######....#######.#..#
##.##...##.#.#...##.###...#.#......#...#.##.########....########.###.#.....#.......#.##..#.#.#..#.##
#.....##########....#...###.#.##########..#......#.##.####.#.#####.#.##.####.##.#.########.#.#######
#####.#.......#####...#..........##.#######.######..#.#..#.#..#.#.....#......####..................#
#...#######.#....##.#.#.#####.####.......####...##.##.#.##.#.##...##.#########.######.#.##.#.##.####
###..#.#######.#..#####....##......#.#####.#..####.##.#.#.......#########..###...##.###..#.#.#####.#
#.##......#....##..#.#..#.####.#.#.#...#.....##.....#.....#.#######...#.##.....###....########.#.#.#
#..######.##.#####.....####.##.#########.#.#....###...##.##.........###.##.#####.#.#####....#..#...#
#.##.####..####.###.##.......####.#.####.#####.######..###..#.#.##.##....#.#.#.#.#.....#.##...##.###
#.......##.##.#..##.##.##.##..............#..#....####.######.#..#######.#.......#.#####..#####..#.#
#.#.###.##.##.#.##..##..#.###.#.#.##.#.##...#######.####.####.##..#.##.#.#.#######.##..##..#.###...#
#.###..............##..##...#####..#.#.##.###.###.#.........#####...##.......#...#..#.##..##.#.#.###
#...##.#.#.##.#.#.##..##..#..#.#..####.##...........###########.######.#.##.##.###.##.###.#........#
##.#########..#.#.###..#.##.##...##..#..#.#.##.##.#....#.##.#....##.#..#.##.................#.##.###
#####.#.#.#..##.#.#...##..######....###.######..#.#.##.#......##......##.##.#.#######.###.###.##...#
#...#.......#####.#.#..##.....##.#.##.#..#.#.#.##.#.##...#.####..#.##########.......#...#..##.##.#.#
###.####.##.....###.#.####.#.##..#....#.##...####.#..##.########.#...#...##...########.##.##...#.#.#
#........#..#.#.#...#...##.#.#..##.#.##....#....#.#.##.........#.#.#...#.##.#........#..#..##.##.#.#
##################################################################################################.#