###############
#...#..##.....#
#.#.......#...#
##..####...#..#
##..#...#..#..#
##......#..#..#
....####...#..#
##..#.........#
#...#....###..#
#...##......#.#
#.....###....##
###....#.#..#..
#..####.....#.#
#.......##....#
###############